NO textures/jul1.xpm
SO textures/jul2.xpm
EA textures/jul4.xpm
WE textures/jul3.xpm
F 220,100,0
C 225,30,0

111111111111111111111111111
100000000110000000000001
1011000001110000000000001
10010000000000000000000011111111
111111111011000001110000000000001
100000000011000001110111111111111
11110111111111011100000010001
1110111111111011101010010001
1000000110101011100000010001
1000000000000001100000010001
1000000000000001101010010001
11000001110101011111011110W011
11110111 1110101 101111010001
11111111 1111111 111111111111