
NO textures/jul4.xpm
SO textures/jul2.xpm
EA textures/jul1.xpm
WE textures/jul3.xpm
C 220,100,0
F 225,30,14


11111111111111111111111111
1000000001100000000000011
1011000001110000000000001
100100000000000000000000111111111
1111111110110000011100000000000011
100W00000011000001110111111111111
11110111111111011100000010001
11011111111101110101001000111
1000000110101011100000010001
1000000000000001100000010N01
10000000000000011010100100011
110000011101010111110111100011
11110111 1110101 101111010001
11111111 1111111 111111111111
