
NO textures/jul4.xpm
SO textures/jul2.xpm
EA textures/jul1.xpm
WE textures/jul3.xpm
C 12     ,  61,   44
F 72   ,21    ,14

11111111111111111111111111111111111111111111111111111111111111111111111111111111111111111111111111111111
10111110000000000000000011111111111111000000000011111100000000000000000011111000000000000011111000000001
10000000000000000000111111111111111111111000000000000000000000111111111111111111111100000000000011000001
11100001111100001100000000000001100000000001111111000000000111111000000000000000000000111000000000000001
10111110000000000000000011111111111111000000000011111100000000000000000011111000000000000011111000000001
10000000000000000000111111111111111111111000000000000000000000111111111111111111111100000000000011000001
11100001111100001100000000000001100000000001111111000000000111111000000000000000000000111000000000000001
10111110000000000000000011111111111111000000000011111100000000000000000011111000000000000011111000000001
10000000000000000000111111111111111111111000000000000000000000111111111111111111111100000000000011000001
11100001111100001100000000000001100000000001111111000000000111111000000000000000000000111000000000000001
10111110000000000000000011111111111111000000000011111100000000000000000011111000000000000011111000000001
10000000000000000000111111111111111111111000000000000000000000111111111111111111111100000000000011000001
11100001111100001100000000000001100000000001111111000000000111111000000000000000000000111000000000000001
10111110000000000000000011111111111111000000000011111100000000000000000011111000000000000011111000000001
10000000000000000000111111111111111111111000000000000000000000111111111111111111111100000000000011000001
11100001111100001100000000000001100000000001111111000000000111111000000000000000000000111000000000000001
10111110000000000000000011111111111111000000000011111100000000000000000011111000000000000011111000000001
10000000000000000000111111111111111111111000000000000000000000111111111111111111111100000000000011000001
11100001111100001100000000000001100000000001111111000000000111111000000000000000000000111000000000000001
10111110000000000000000011111111111111000000000011111100000000000000000011111000000000000011111000000001
10000000000000000000111111111111111111111000000000000000000000111111111111111111111100000000000011000001
11100001111100001100000000000001100000000001111111000000000111111000000000000000000000111000000000000001
10111110000000000000000011111111111111000000000011111100000000000000000011111000000000000011111000000001
10000000000000000000111111111111111111111000000000000000000000111111111111111111111100000000000011000001
11100001111100001100000000000001100000000001111111000000000111111000000000000000000000111000000000000001
10111110000000000000000011111111111111000000000011111100000000000000000011111000000000000011111000000001
10000000000000000000111111111111111111111000000000000000000000111111111111111111111100000000000011000001
11100001111100001100000000000001100000000001111111000000000111111000000000000000000000111000000000000001
10111110000000000000000011111111111111000000000011111100000000000000000011111000000000000011111000000001
10000000000000000000111111111111111111111000000000000000000000111111111111111111111100000000000011000001
11100001111100001100000000000001100000000001111111000000000111111000000000000000000000111000000000000001
101111100000000000000000111111111111110000W0000011111100000000000000000011111000000000000011111000000001
10000000000000000000111111111111111111111000000000000000000000111111111111111111111100000000000011000001
11100001111100001100000000000001100000000001111111000000000111111000000000000000000000111000000000000001
10111110000000000000000011111111111111000000000011111100000000000000000011111000000000000011111000000001
10000000000000000000111111111111111111111000000000000000000000111111111111111111111100000000000011000001
11100001111100001100000000000001100000000001111111000000000111111000000000000000000000111000000000000001
10111110000000000000000011111111111111000000000011111100000000000000000011111000000000000011111000000001
10000000000000000000111111111111111111111000000000000000000000111111111111111111111100000000000011000001
11100001111100001100000000000001100000000001111111000000000111111000000000000000000000111000000000000001
10111110000000000000000011111111111111000000000011111100000000000000000011111000000000000011111000000001
10000000000000000000111111111111111111111000000000000000000000111111111111111111111100000000000011000001
11100001111100001100000000000001100000000001111111000000000111111000000000000000000000111000000000000001
10111110000000000000000011111111111111000000000011111100000000000000000011111000000000000011111000000001
10000000000000000000111111111111111111111000000000000000000000111111111111111111111100000000000011000001
11100001111100001100000000000001100000000001111111000000000111111000000000000000000000111000000000000001
10111110000000000000000011111111111111000000000011111100000000000000000011111000000000000011111000000001
10000000000000000000111111111111111111111000000000000000000000111111111111111111111100000000000011000001
11100001111100001100000000000001100000000001111111000000000111111000000000000000000000111000000000000001
10111110000000000000000011111111111111000000000011111100000000000000000011111000000000000011111000000001
10000000000000000000111111111111111111111000000000000000000000111111111111111111111100000000000011000001
11100001111100001100000000000001100000000001111111000000000111111000000000000000000000111000000000000001
10111110000000000000000011111111111111000000000011111100000000000000000011111000000000000011111000000001
10000000000000000000111111111111111111111000000000000000000000111111111111111111111100000000000011000001
11100001111100001100000000000001100000000001111111000000000111111000000000000000000000111000000000000001
10111110000000000000000011111111111111000000000011111100000000000000000011111000000000000011111000000001
10000000000000000000111111111111111111111000000000000000000000111111111111111111111100000000000011000001
11100001111100001100000000000001100000000001111111000000000111111000000000000000000000111000000000000001
10111110000000000000000011111111111111000000000011111100000000000000000011111000000000000011111000000001
10000000000000000000111111111111111111111000000000000000000000111111111111111111111100000000000011000001
11100001111100001100000000000001100000000001111111000000000111111000000000000000000000111000000000000001
10111110000000000000000011111111111111000000000011111100000000000000000011111000000000000011111000000001
10000000000000000000111111111111111111111000000000000000000000111111111111111111111100000000000011000001
11100001111100001100000000000001100000000001111111000000000111111000000000000000000000111000000000000001
10111110000000000000000011111111111111000000000011111100000000000000000011111000000000000011111000000001
10000000000000000000111111111111111111111000000000000000000000111111111111111111111100000000000011000001
11100001111100001100000000000001100000000001111111000000000111111000000000000000000000111000000000000001
10111110000000000000000011111111111111000000000011111100000000000000000011111000000000000011111000000001
10000000000000000000111111111111111111111000000000000000000000111111111111111111111100000000000011000001
11100001111100001100000000000001100000000001111111000000000111111000000000000000000000111000000000000001
10111110000000000000000011111111111111000000000011111100000000000000000011111000000000000011111000000001
10000000000000000000111111111111111111111000000000000000000000111111111111111111111100000000000011000001
11100001111100001100000000000001100000000001111111000000000111111000000000000000000000111000000000000001
10111110000000000000000011111111111111000000000011111100000000000000000011111000000000000011111000000001
10000000000000000000111111111111111111111000000000000000000000111111111111111111111100000000000011000001
11100001111100001100000000000001100000000001111111000000000111111000000000000000000000111000000000000001
10111110000000000000000011111111111111000000000011111100000000000000000011111000000000000011111000000001
10000000000000000000111111111111111111111000000000000000000000111111111111111111111100000000000011000001
11100001111100001100000000000001100000000001111111000000000111111000000000000000000000111000000000000001
10111110000000000000000011111111111111000000000011111100000000000000000011111000000000000011111000000001
10000000000000000000111111111111111111111000000000000000000000111111111111111111111100000000000011000001
11100001111100001100000000000001100000000001111111000000000111111000000000000000000000111000000000000001
10111110000000000000000011111111111111000000000011111100000000000000000011111000000000000011111000000001
10000000000000000000111111111111111111111000000000000000000000111111111111111111111100000000000011000001
11100001111100001100000000000001100000000001111111000000000111111000000000000000000000111000000000000001
10111110000000000000000011111111111111000000000011111100000000000000000011111000000000000011111000000001
10000000000000000000111111111111111111111000000000000000000000111111111111111111111100000000000011000001
11100001111100001100000000000001100000000001111111000000000111111000000000000000000000111000000000000001
10111110000000000000000011111111111111000000000011111100000000000000000011111000000000000011111000000001
10000000000000000000111111111111111111111000000000000000000000111111111111111111111100000000000011000001
11100001111100001100000000000001100000000001111111000000000111111000000000000000000000111000000000000001
10111110000000000000000011111111111111000000000011111100000000000000000011111000000000000011111000000001
10000000000000000000111111111111111111111000000000000000000000111111111111111111111100000000000011000001
11100001111100001100000000000001100000000001111111000000000111111000000000000000000000111000000000000001
10111110000000000000000011111111111111000000000011111100000000000000000011111000000000000011111000000001
10000000000000000000111111111111111111111000000000000000000000111111111111111111111100000000000011000001
11100001111100001100000000000001100000000001111111000000000111111000000000000000000000111000000000000001
10111110000000000000000011111111111111000000000011111100000000000000000011111000000000000011111000000001
10000000000000000000111111111111111111111000000000000000000000111111111111111111111100000000000011000001
11100001111100001100000000000001100000000001111111000000000111111000000000000000000000111000000000000001
10111110000000000000000011111111111111000000000011111100000000000000000011111000000000000011111000000001
10000000000000000000111111111111111111111000000000000000000000111111111111111111111100000000000011000001
11100001111100001100000000000001100000000001111111000000000111111000000000000000000000111000000000000001
10111110000000000000000011111111111111000000000011111100000000000000000011111000000000000011111000000001
10000000000000000000111111111111111111111000000000000000000000111111111111111111111100000000000011000001
11100001111100001100000000000001100000000001111111000000000111111000000000000000000000111000000000000001
10111110000000000000000011111111111111000000000011111100000000000000000011111000000000000011111000000001
10000000000000000000111111111111111111111000000000000000000000111111111111111111111100000000000011000001
11100001111100001100000000000001100000000001111111000000000111111000000000000000000000111000000000000001
10111110000000000000000011111111111111000000000011111100000000000000000011111000000000000011111000000001
10000000000000000000111111111111111111111000000000000000000000111111111111111111111100000000000011000001
11100001111100001100000000000001100000000001111111000000000111111000000000000000000000111000000000000001
10111110000000000000000011111111111111000000000011111100000000000000000011111000000000000011111000000001
10000000000000000000111111111111111111111000000000000000000000111111111111111111111100000000000011000001
11100001111100001100000000000001100000000001111111000000000111111000000000000000000000111000000000000001
10111110000000000000000011111111111111000000000011111100000000000000000011111000000000000011111000000001
10000000000000000000111111111111111111111000000000000000000000111111111111111111111100000000000011000001
11100001111100001100000000000001100000000001111111000000000111111000000000000000000000111000000000000001
10111110000000000000000011111111111111000000000011111100000000000000000011111000000000000011111000000001
10000000000000000000111111111111111111111000000000000000000000111111111111111111111100000000000011000001
11100001111100001100000000000001100000000001111111000000000111111000000000000000000000111000000000000001
10111110000000000000000011111111111111000000000011111100000000000000000011111000000000000011111000000001
10000000000000000000111111111111111111111000000000000000000000111111111111111111111100000000000011000001
11100001111100001100000000000001100000000001111111000000000111111000000000000000000000111000000000000001
10111110000000000000000011111111111111000000000011111100000000000000000011111000000000000011111000000001
10000000000000000000111111111111111111111000000000000000000000111111111111111111111100000000000011000001
11100001111100001100000000000001100000000001111111000000000111111000000000000000000000111000000000000001
10111110000000000000000011111111111111000000000011111100000000000000000011111000000000000011111000000001
10000000000000000000111111111111111111111000000000000000000000111111111111111111111100000000000011000001
11100001111100001100000000000001100000000001111111000000000111111000000000000000000000111000000000000001
10111110000000000000000011111111111111000000000011111100000000000000000011111000000000000011111000000001
10000000000000000000111111111111111111111000000000000000000000111111111111111111111100000000000011000001
11100001111100001100000000000001100000000001111111000000000111111000000000000000000000111000000000000001
10111110000000000000000011111111111111000000000011111100000000000000000011111000000000000011111000000001
10000000000000000000111111111111111111111000000000000000000000111111111111111111111100000000000011000001
11100001111100001100000000000001100000000001111111000000000111111000000000000000000000111000000000000001
11111111111111111111111111111111111111111111111111111111111111111111111111111111111111111111111111111111
