
NO textures/jul4.xpm
SO textures/jul2.xpm
EA textures/jul1.xpm
WE textures/jul3.xpm
C 220,100,0
F 225,30,14
                                                                 111111111111111111
                                                                 100000000000000001
                                                                 100000000000000001
                                                                 100001111110000001
                                                                 100001000010000001
                                                                 1000010S0010000001
                                                                 100000000110000001
                                                                 100000000000000001
                                                                 100000000000000001
                                                                 100000000001111111
11111111111111111111111111111111111111111111111111111111111111111100000000001111111
10000000000000000000011111100000000000000000000000000000000000000000000000001111111
10000000000000000000011111100000000000000000000000000000000000000000000000000000001
10000000000000000000011111100000000000000000000000000000000000000000000000000000001
10000000000000000000011111100000000000000000000000000000000000000000000000000000001
10000000000000000000011111100000000000000000000000000000000000000000000000000000001
10000000000000000000000000000000000000000000000000000000000000000000000000000000001
10000000000000000000000000000000000001010100000000000000000000000000000000000000001
10000000000000000100000000000000001000000000000000000000001000000000000000000000001
10000000000010000000000011100000000000000000110000000000000000010000000000000000001
10000000000000000000000011100000000000000000000000000000000000000000000110000000001
10000000000000000000000001110000000000000000000000000000000000000000011100000000001
10000000000000000000000001110000000000000000000000000000000000000000011100000000001
10000000000000000000000001110000000000000000000000000000000000000000011100000000001
10000000000000000000000001110000000000000000000000000000000000000000011100000000001
10000000000000000000000001110000000000000000000000000000000000000000011100000000001
10000000000000000000000001110000000000000000000000000000000000000000011100000000001
10000000000000000000000000000000000000000000000000000000000000000000000000000000011
10000000000000000000000000000000000000000000000000000000000000000000000000000000011
10000000000000000000000000000000000000000000000000000000000000000000000000000000011
10000000000000000000000000000000000000000000000000000000000000000000000000000000011
10000000000000000000000000000000000000000000000000000000000000000000000000000000011
10000000000000000000000001110000000000000000000000000000000000000000011100000000001
11111111111111111111111111111111111111111111111111111111111111111111111111111111111
