
NO textures/jul4.xpm
SO textures/jul2.xpm
EA textures/jul1.xpm
WE textures/jul3.xpm
C 220,100,0
F 225,30,14

111111
100001
1100W1
111111
